"filename", "language", "C", "C++", "comment", "blank", "total"
"f:\Project\packet\changeType.c", "C", 37, 0, 0, 7, 44
"f:\Project\packet\changeType.h", "C++", 0, 4, 0, 3, 7
"f:\Project\packet\receiveFrame.c", "C", 194, 0, 3, 26, 223
"f:\Project\packet\receiveFrame.h", "C++", 0, 41, 5, 5, 51
"f:\Project\packet\receivePacket.c", "C", 47, 0, 0, 2, 49
"f:\Project\packet\receivePacket.h", "C++", 0, 6, 0, 3, 9
"f:\Project\packet\sendFrame.c", "C", 0, 0, 0, 1, 1
"f:\Project\packet\sendFrame.h", "C++", 0, 0, 0, 1, 1
"f:\Project\packet\sendPacket.c", "C", 48, 0, 0, 1, 49
"f:\Project\packet\sendPacket.h", "C++", 0, 6, 0, 3, 9
"Total", "-", 326, 57, 8, 52, 443