"filename", "language", "C", "C++", "comment", "blank", "total"
"f:\Project\packet\changeType.c", "C", -37, 0, 0, -7, -44
"f:\Project\packet\changeType.h", "C++", 0, -4, 0, -3, -7
"f:\Project\packet\receiveFrame.c", "C", -194, 0, -3, -26, -223
"f:\Project\packet\receiveFrame.h", "C++", 0, -41, -5, -5, -51
"f:\Project\packet\receivePacket.c", "C", -47, 0, 0, -2, -49
"f:\Project\packet\receivePacket.h", "C++", 0, -6, 0, -3, -9
"f:\Project\packet\sendFrame.c", "C", 0, 0, 0, -1, -1
"f:\Project\packet\sendFrame.h", "C++", 0, 0, 0, -1, -1
"f:\Project\packet\sendPacket.c", "C", -48, 0, 0, -1, -49
"f:\Project\packet\sendPacket.h", "C++", 0, -6, 0, -3, -9
"f:\Project\test\changeType.c", "C", 30, 0, 1, 5, 36
"f:\Project\test\file.c", "C", 17, 0, 13, 11, 41
"f:\Project\test\progressBar.c", "C", 27, 0, 20, 5, 52
"f:\Project\test\shortestPath.c", "C", 81, 0, 6, 6, 93
"f:\Project\test\sort.c", "C", 41, 0, 0, 6, 47
"f:\Project\test\tansmit.c", "C", 18, 0, 31, 5, 54
"Total", "-", -112, -57, 63, -14, -120